5,0,0,0,0,0,0,0,0,0,0,0,1,0,0,0,0,0,0,0,0
5,0,0,0,0,0,0,0,0,0,0,0,1,2,0,0,0,0,0,0,0
5,0,0,0,0,0,0,0,0,0,0,0,1,1,0,0,0,0,0,0,1
5,0,0,0,0,0,0,0,0,0,4,0,0,1,0,0,0,0,0,0,1
5,0,0,0,0,0,0,0,1,1,1,1,3,0,0,0,0,0,0,0,1
5,0,0,0,0,0,0,0,5,0,0,0,0,0,0,0,0,0,1,1,1
5,0,0,0,0,1,1,1,5,0,0,0,0,0,0,0,0,0,0,0,1
5,0,0,0,0,0,0,0,5,0,0,0,0,0,0,0,0,0,0,0,1
5,0,0,0,0,0,0,0,5,0,0,0,0,0,0,0,0,1,1,1,1
5,11,1,1,0,0,0,0,0,0,0,0,0,0,0,0,0,0,0,0,1
5,0,0,0,0,0,0,0,0,0,0,0,0,0,0,0,0,0,0,0,1
5,0,0,4,0,0,0,0,0,0,0,0,0,0,0,4,4,0,0,0,1
1,1,1,1,1,1,1,1,0,0,0,0,0,1,1,1,1,1,1,1,1
1,1,1,1,1,1,1,1,0,0,0,0,0,1,1,1,1,1,1,1,1
1,1,1,1,1,1,1,1,5,5,5,5,5,1,1,1,1,1,1,1,1
1,1,1,1,1,1,1,1,1,1,1,1,1,1,1,1,1,1,1,1,1

1,1,1,1,1
1,0,0,0,1
1,0,0,0,1
1,1,1,1,1

1,1,1,1,1
1,0,0,0,1
1,0,0,0,1
1,1,0,1,1
0,1,0,1,0
1,1,0,1,1
1,0,0,0,1
1,0,0,0,1
1,0,0,0,1
1,0,0,0,1
1,1,1,1,1

1,1,1,1
1,0,0,1
1,0,0,1,
1,0,0,1
1,1,1,1