1,11,1,1,1,1,1,1,1,1,1,1,1,1,1,1,1,1,1,1,1,1,1
1,0,0,0,0,0,0,0,0,1,1,1,0,0,0,0,0,1,0,0,0,0,1
1,0,0,0,0,0,0,0,0,1,1,1,0,0,0,0,0,1,0,0,0,0,1
1,0,0,0,0,0,0,0,0,1,1,1,0,0,0,0,0,1,0,0,0,0,1
1,1,1,1,1,0,0,0,0,1,1,1,0,0,0,0,0,1,0,0,0,0,1
1,1,1,1,1,0,0,0,0,1,1,1,0,0,0,0,0,1,0,0,0,0,1
1,0,0,0,1,0,0,0,0,1,1,1,0,0,0,0,0,1,0,0,0,0,1
1,0,0,0,1,0,0,0,0,1,4,1,0,0,0,0,0,1,0,0,0,0,1
1,0,0,0,1,0,0,0,0,1,1,1,0,0,0,0,0,1,0,0,0,0,1
1,0,0,0,1,0,0,0,0,0,0,0,0,0,0,0,0,1,2,0,0,0,1
1,0,0,0,0,0,0,0,0,0,0,0,0,0,0,0,0,1,1,1,0,0,1
1,0,0,0,0,0,0,0,0,0,0,0,0,0,0,0,0,0,0,0,0,0,1
1,0,4,0,0,0,0,0,0,0,0,0,0,0,0,0,0,0,0,0,0,0,1
1,1,1,1,1,0,0,0,0,0,0,0,0,0,0,1,1,1,1,1,1,1,1
1,1,1,1,1,0,0,0,0,0,0,0,0,0,0,1,1,1,1,1,1,1,1
1,1,1,1,1,5,5,5,5,5,5,5,5,5,5,1,1,1,1,1,1,1,1
,,,,,,,,,,,,,,,,,,,,,,
1,2,2,2,3,,,,,,,,,,,,,,,,,,
8,0,0,0,4,,,,,,,,,,,,,,,,,,
8,0,0,0,4,,,,,,,,,,,,,,,,,,
8,0,0,0,4,,,,,,,,,,,,,,,,,,
7,6,6,6,5,,,,,,,,,,,,,,,,,,
,,,,,,,,,,,,,,,,,,,,,,
1,2,2,2,2,2,3,,,,,,,,,,,,,,,,
8,0,0,0,0,0,4,,,,,,,,,,,,,,,,
8,0,0,0,0,0,4,,,,,,,,,,,,,,,,
8,0,0,0,0,0,4,,,,,,,,,,,,,,,,
8,0,0,0,0,0,4,,,,,,,,,,,,,,,,
8,0,0,0,0,0,4,,,,,,,,,,,,,,,,
8,0,0,0,0,0,4,,,,,,,,,,,,,,,,
7,6,6,6,6,6,5,,,,,,,,,,,,,,,,